{
	"levelRows" : [
		"....................",
		"....P...............",
		"....................",
		"AAAAA.....AAAAAAAAAA",
		"....................",
		"....................",
		"....................",
		"DDDDDDD.............",
		"....................",
		".............DDDDDDD",
		"....................",
		"....................",
		"...EEEEEEEEEEEEEEEEE",
		".....Q..............",
		"...................."
	]
}