{
	"levelRows" : [
		"....................",
		".................P..",
		"....................",
		"...A....A....A...A..",
		".....A...A..A...A...",
		"....................",
		"...C.....C...C....C.",
		"....C.....C...C....C",
		"....................",
		"BBBBBBBB............",
		"....................",
		".....DDD............",
		"....................",
		"..Q...E.............",
		"...................."
	]
}