{
	"levelRows" : [
		"....................",
		"....P...............",
		"....................",
		"....................",
		"....................",
		"....................",
		"...AAAAA......AAAAA...",
		"....................",
		"....................",
		".............BBBBB..",
		"....................",
		"...............Q....",
		"....................",
		"....................",
		"...................."
	]
}