{
	"levelRows" : [
		"....................",
		"...DDDDDDFFDDDD.....",
		"...B..........B.....",
		"...B.P........B.....",
		"...B..........B.....",
		"...B..........B.....",
		"...B..........B.....",
		"...B..........B.....",
		"...B..........B.....",
		"...B.......Q..B.....",
		"...B..........B.....",
		"...CCCCCCEECCCC.....",
		"....................",
		"....................",
		"...................."
	]
}