{
	"levelRows" : [
		"....................",
		"AAAAAAA.............",
		"...P..A.............",
		"......A.............",
		"......A..............",
		"......B.......C.....",
		"......B.......C.....",
		"..............C.....",
		"BBB...........C.....",
		"..............C.....",
		".......CCCCCCCC.....",
		"....................",
		"...............Q....",
		"....................",
		"...................."
	]
}