{
	"levelRows" : [
		"....................",
		"....P...............",
		"....................",
		"....................",
		"....................",
		"....................",
		"...AAAAA......AAAAA...",
		"....................",
		"....................",
		"............BBBBBB..",
		"............B.......",
		"............B..Q....",
		"............B.......",
		"....................",
		"...................."
	]
}