{
	"levelRows" : [
		"....................",
		"....P...............",
		"....................",
		"....................",
		"....................",
		"....................",
		"...AAAA........AAAA.",
		"....................",
		"....................",
		"............BBBBBB..",
		"....................",
		"...............Q....",
		"....................",
		"....................",
		"...................."
	]
}