{
	"levelRows" : [
		"....................",
		"A...A...............",
		".A.P.A..............",
		"..A...A.............",
		"...A...A............",
		"....A...A...........",
		".....A...A..........",
		"......A....A........",
		"......C....C........",
		"......C....C........",
		"......C....C........",
		"......D....D........",
		".......D....D.......",
		"........D..Q.D......",
		".........DDDDDD....."
	]
}