{
	"levelRows" : [
		"....................",
		".................P..",
		"....................",
		"...A....A....A...A..",
		".....A...A..A...A...",
		"....................",
		"...C.....C...C....C.",
		"....C.....C...C....C",
		"....................",
		"BBBBBBBB............",
		".......B............",
		"....................",
		".Q..................",
		".......B............",
		"BBBBBBBB............"
	]
}