{
	"levelRows" : [
		"....................",
		"....P...............",
		"....................",
		"AAAAA.....AAAAAAAAAA",
		"....................",
		"BBBBBBBBBBBBBBB.....",
		"....................",
		".....CCCCCCCCCCCCCCC",
		"....................",
		"DDDDDDD......DDDDDDD",
		"....................",
		"EEEEEEEEEEEEEEE.....",
		"....................",
		".....Q..............",
		"...................."
	]
}