{
	"levelRows" : [
		"....................",
		"...DDDDDDFFDDDD.....",
		"..............B..Q..",
		"..........P...B.....",
		"..............B.....",
		"..............B.....",
		"......AAAAAAAAB.....",
		"..............B.....",
		"..............B.....",
		"..............B.....",
		"..............B.....",
		"...CCCCCCEECCCC.....",
		"....................",
		"....................",
		"...................."
	]
}