{
	"levelRows" : [
		".........A..........",
		"...P.....A.....Q....",
		".........A..........",
		".........A..........",
		".........A..........",
		".........A..........",
		".........A..........",
		".........A..........",
		".........A..........",
		".........A..........",
		".........A..........",
		"....................",
		"....................",
		"....................",
		"...................."
	]
}